#############
# #  X  #   #
# # # # ### #
# # # #     #
# # ### ### #
# #   #   # #
# # # ### ###
# # #   #   #
# # ####### #
#   #     # #
### # ### # #
#   #   #   #
####### #####
